5 1 11 11
11111111111
D0000S0000D
10000000001
11111011111
1K001010001
10001000001
1000T0T0001
10001110001
10000000001
1000TTT0001
11111111111

4 1 11 11
11111111111
10000000000
10000000001
11111011111
11111011111
11111011111
11111011111
11111011111
11111011111
11111011111
11111011111

6 1 11 11
11111111111
0000TTTT001
10000000001
11111011111
11111011111
11111011111
11111011111
11111011111
11111011111
11111011111
11111011111

3 2 11 11
11111111111
100TTTT0000
10000000001
11111011111
11111011111
11111011111
11111011111
11111011111
11111011111
11111011111
11111011111

4 2 11 11
11111011111
00000000001
10TT000TT01
11111011111
11111011111
11111011111
11111011111
11111011111
11111011111
11111011111
11111011111

5 2 11 11
11111111111
10000000001
10000000001
10011111001
1T0000000T1
11110001111
10000000001
100TTTTT001
10111111101
10000000001
11111011111

6 2 11 11
11111011111
10000000000
10000000001
11111111111

7 2 11 11
11111111111
00T00000T01
1000T0T00K1
11111011111
11111011111
11111011111
11111011111
11111011111
11111011111
11111011111
11111011111

2 3 11 11
11111111111
1T010K01000
10010001001
10T10001T01
10010001001
1T0100010T1
10010001001
10T10001T01
10010001001
10000000001
11111111111

3 3 11 11
11111011111
00T0T000001
10000000001
11111111111

4 3 11 11
11111011111
10111011100
100T000T001
10000000001
1TTTTTTTTT1
11111111111

5 3 11 11
11111011111
000T000T000
10000000001
11111011111
11111011111
11111011111
11111011111
11111011111
11111011111
11111011111
11111011111

6 3 11 11
11111111111
00T000T0000
1000T000T01
11111111111

7 3 11 11
11111011111
00TT000TT00
10000000001
11111011111
11111011111
11111011111
11111011111
11111011111
11111011111
11111011111
11111011111

8 3 11 11
11111111111
00000000001
10000000001
1111T001111
1000T0010K1
1000T001001
10000001001
10000001001
10000000001
11111011111
11111011111

1 4 11 11
G

2 4 11 11
11111111111
00000000000
10000000001
11111111111

3 4 11 11
11111111111
D0000000000
10000000001
11111111111

4 4 11 11
11111111111
D0111111100
100T000T001
10000T00001
1TTTTTTTTT1
11111111111

5 4 11 11
11111011111
00000000000
10000000001
11111111111

6 4 11 11
11111111111
00111111101
100T0000T01
10000000001
1TTTTTTTTT1
11111111111

7 4 11 11
11111011111
10TT000TT00
10000000001
11111111111

8 4 11 11
11111011111
00111011100
100T000T001
1T000000001
1TTTTTTTTT1
11111111111

9 4 11 11
11111111111
00000000001
10000000001
11111111111