1 1 10 10
1111111111
1000000001
10000S0001
1011111101
1000000001
1000000001
10000T1111
1000000000
1T000T1111
111D111111

2 1 10 10
1111111111
1T000T1TT1
1001001001
1001001001
1001000001
1001000001
1001001001
0001001001
1TT1TT1001
1111111101

2 2 10 10
1111111101
1000000001
1001111111
10000000T1
11111110T1
1T000000T1
1T00111111
1T00000001
1T000000K1
1111111111

1 2 10 10
G