0 0 10 10
1111111111
1000000001
10000S0001
1011111101
1000000001
1000000001
1000001111
1000000000
1000001111
111D111111

1 0 10 10
1111111111
1000001001
1001001001
1001001001
1001000001
1001000001
1001001001
0001001001
1001001001
1111111101

1 1 10 10
1111111101
1000000001
1001111111
1000000001
1111111001
1000000001
1000111111
1000000001
10000000K1
1111111111

0 1 10 10
G