5 1 11 11
|||||||||||
11111111111
|111111111|
|||||2|||||
|555|2|333|
|555|22333|
|555222333|
|555|||333|
|555444333|
|555444333|
|||||||||||

4 1 11 11
|||||||||||
|0000000000
|000000000|
|||||0|||||
|||||0|||||
|||||0|||||
|||||0|||||
|||||0|||||
|||||0|||||
|||||0|||||
|||||0|||||

6 1 11 11
|||||||||||
1111222222|
|111222222|
|||||3|||||
|||||3|||||
|||||3|||||
|||||3|||||
|||||3|||||
|||||3|||||
|||||3|||||
|||||3|||||

3 2 11 11
|||||||||||
|2222221111
|222222111|
|||||3|||||
|||||3|||||
|||||3|||||
|||||3|||||
|||||3|||||
|||||3|||||
|||||3|||||
|||||3|||||

4 2 11 11
|||||0|||||
0000000000|
|000000000|
|||||0|||||
|||||0|||||
|||||0|||||
|||||0|||||
|||||0|||||
|||||0|||||
|||||0|||||
|||||0|||||

5 2 11 11
|||||||||||
|000000000|
|000000000|
|00|||||00|
|000000000|
||||000||||
|000000000|
|000000000|
|0|||||||0|
|000000000|
|||||0|||||

6 2 11 11
|||||0|||||
|0000000000
|000000000|
|||||||||||

7 2 11 11
|||||||||||
1112235555|
|112235555|
|||||4|||||
|||||4|||||
|||||4|||||
|||||4|||||
|||||4|||||
|||||4|||||
|||||4|||||
|||||4|||||

2 3 11 11
|||||||||||
|44|444|111
|44|444|11|
|44|444|22|
|44|444|22|
|44|444|22|
|44|444|33|
|44|444|33|
|44|444|33|
|444444444|
|||||||||||

3 3 11 11
|||||0|||||
1110000000|
|110000000|
|||||||||||

4 3 11 11
|||||2|||||
|0|||2|||11
|000000011|
|000000011|
|000000000|
|000000000|
|000000000|
|000000000|
|000000000|
|000000000|
|||||||||||

5 3 11 11
|||||2|||||
33332221111
|333222111|
|||||4|||||
|||||4|||||
|||||4|||||
|||||4|||||
|||||4|||||
|||||4|||||
|||||4|||||
|||||4|||||

6 3 11 11
|||||||||||
55533331111
|444222211|
|||||||||||

7 3 11 11
|||||2|||||
33332221111
|332222211|
|||||0|||||
|||||0|||||
|||||0|||||
|||||0|||||
|||||0|||||
|||||0|||||
|||||0|||||
|||||0|||||

8 3 11 11
|||||||||||
2222222222|
|222222222|
||||111||||
|000111|00|
|000111|00|
|000000|00|
|000000|00|
|000000000|
|||||0|||||
|||||0|||||

1 4 11 11
00000000000
00000000000
00000000000
00000000000
G

2 4 11 11
|||||||||||
00000000000
|000000000|
|||||||||||

3 4 11 11
|||||||||||
00000000000
|000000000|
|||||||||||

4 4 11 11
|||||||||||
44|||||||11
|444332111|
|443332211|
|000000000|
|000000000|
|000000000|
|000000000|
|000000000|
|000000000|
|||||||||||

5 4 11 11
|||||0|||||
00000000000
|000000000|
|||||||||||

6 4 11 11
|||||||||||
00|||||||0|
|000000000|
|000000000|
|000000000|
|000000000|
|000000000|
|000000000|
|000000000|
|000000000|
|||||||||||

7 4 11 11
|||||2|||||
|0002221111
|000000001|
|||||||||||

8 4 11 11
|||||3|||||
44|||3|||11
|444222111|
|442222211|
|000000000|
|000000000|
|000000000|
|000000000|
|000000000|
|000000000|
|||||||||||

9 4 11 11
|||||||||||
0000000000|
|000000000|
|||||||||||