5 1 11 11
11111111111
11111111111
11111111111
22222222222
55552223333
55552223333
55552223333
55552223333
55554443333
55554443333
55554443333

4 1 11 11
11111111111
11111111111
11111111111
11111111111
11111111111
11111111111
11111111111
11111111111
11111111111
11111111111
11111111111

6 1 11 11
11111111111
11112222222
11112222222
11111311111
11111311111
11111311111
11111311111
11111311111
11111311111
11111311111
11111311111

3 2 11 11
11111111111
12222221111
12222221111
11111311111
11111311111
11111311111
11111311111
11111311111
11111311111
11111311111
11111311111

4 2 11 11
11111011111
00000000001
10000000001
10000000001
11111011111
11111011111
11111011111
11111011111
11111011111
11111011111
11111011111
11111011111

5 2 11 11
11111111111
10000000001
10000000001
10011111001
10000000001
11110001111
10000000001
10000000001
10111111101
10000000001
11111011111

6 2 11 11
11111011111
10000000000
10000000001
11111111111

7 2 11 11
11111111111
11122355551
11122355551
11111411111
11111411111
11111411111
11111411111
11111411111
11111411111
11111411111
11111411111

2 3 11 11
11111111111
14414441111
14414441111
14414441221
14414441221
14414441221
14414441331
14414441331
14414441331
14444444441
11111111111

3 3 11 11
11111111111
22211111111
12211111111
11111111111

4 3 11 11
11111311111
12111311111
12222222111
12222222111
11111111111
11111111111
11111111111
11111111111
11111111111
11111111111
11111111111

5 3 11 11
11111211111
33332221111
13332221111
11111411111
11111411111
11111411111
11111411111
11111411111
11111411111
11111411111
11111411111

6 3 11 11
11111111111
55533331111
14442222111
11111111111

7 3 11 11
11111211111
33332221111
13322222111
11111311111
11111311111
11111311111
11111311111
11111311111
11111311111
11111311111
11111311111

8 3 11 11
22222222222
22222222222
22222222222
11111111111
10001111001
10001111001
10000000001
10000000001
10000000001
11111011111
11111011111

1 4 11 11
00000000000
00000000000
00000000000
00000000000
G

2 4 11 11
11111111111
00000000000
10000000001
11111111111

3 4 11 11
11111111111
00000000000
10000000001
11111111111

4 4 11 11
11111111111
44111111111
14443321111
14433122111
11111111111
10000000001
10000000001
10000000001
10000000001
10000000001
11111111111

5 4 11 11
11111011111
00000000000
10000000001
11111111111

6 4 11 11
11111111111
00111111101
10000000001
10000000001
10000000001
10000000001
10000000001
10000000001
10000000001
10000000001
11111111111

7 4 11 11
11111311111
12223331111
12222222211
11111111111

8 4 11 11
11111311111
44111311111
14442221111
14422222111
10000000001
10000000001
10000000001
10000000001
10000000001
10000000001
11111111111

9 4 11 11
11111111111
00000000001
10000000001
11111111111
