0 0 10 10
1111111111
1000000001
1000000001
1000000001
10000S0001
1000000001
1000000001
1000000001
1000000001
1111111101

0 1 10 10
G